XXXXXXXX
X______X
X___X__X
X__XX__X
XXXXXXXX